+++++++++
+S      +
+ +++++ +
+ +   + +
+ +++ + +
+   + + +
+++++ + +
+       +
+ +++++++
