+++++++++++++++ ++++++
+   +   ++ ++   +    +
+     +     +++ ++++++
+ +    ++  ++++ +++ ++
+ +   + + ++    +++  +
+              ++  + +
+++++ + +      ++  + +
+++++ +++  + +  ++   +
+          + + S+ +  +
+++++ +  + + +     + +
++++++++++++++++++++++
